##############################
#P...s..........#####....$...#
#...#######....s.....g...#####
########s....#######....######
###....$.....###....g..s....##
#..g......$############.....##
##########....$..#########g###
#...g....s..####s....s##..s..#
#..s#########...$....g...#####
##############################